R 1000 600
NO ./red.xpm

WE ./Seamless_White_Brick_Texture.xpm
SO ./gray5.xpm

F 0,200,125
EA ./black.xpm
S ./tree4.xpm

C     0  ,125,200
        1111111111111111111111111
        1000002000110001000000001
        1011000001110000000020001
        100100N000000001000200001
111111111011000001110001002200001
100000000011002001110111111111111
11110111111111011100000010001
11110111111111011101010010001
11000000110101011100200010001
10000000000000021100000010001
10002000000000021101010010001
1100000111010101111101111000111
11110111 1110101 101111010001
11111111 1111111 111111111111
